111111111111111111111111111111
100000000000000000000000001111
124350000000000000000000001
100000111111111111000000001111
100000000000000000000000000001
100000000000000000000000000001
111111111111111111111111111111